E E E E E E E E E E E E E E E E E E E E E E E E E E E E E E E E
E 0 A A A A A A A A A A A A A A A A A A A A A A A A A A A A A E
E A A 3 A A A A A A A 1 A E E W W W W W W W W E E A A A 5 A A E
E E W E F F F F E E E E E E E E W W W W W W W E E A A A A A A E
E E W E E F F E E E E E E E E E E W W W W W W E E A A A A A A E
E E W E E E E E E E E E E E E E E E W W W W W E E A A A A A A E
E E W E E E A A A E E E A E E E E E E E E E E E E A A A E A A E
E E W E E A A A A A E E E E A A A A A A A A A A E A A A A A A E
E E W E A A A 2 A A A E E E A A A A A A 4 A A A A A A A A E A E
E E W W W E E E E E W W E E W W W E F F E A A A A A A A E E A E
E E W W E E E E E E W W W W W W W E E E E F F F E A A E E E E E
E E W E E E E E E E W W E E W W W E E E E E E E E A E E E E E E
E W W W W E W W W E W E E E W W W E E E E E E F F F E F F E E E
E W W W W E W W W W W E W W W W W E F F F F F F F F F F F E E E
E E E E E E E E E E E E E E E E E E E E E E E E E E E E E E E E
